111111111111111111111111111111
122222222222222222222222222221
122222222222222222222222222221
122222222222222222222222222221
122222222222222222222222222221
122222222222222222222222222221
122222222222222222232222222221
122222222222222222232222222221
12222222222222e222232222222221
122222222222222222232222222221
122222222222222222222222222221
122222222222222222222222222221
122222222222222222222222222221
122222222222222222222222222221
122222222222222222222222222221
122222222222222222222222222221
122222222222222222222222222221
122222222222222222222222222221
122222222222222222222222222221
111111111111111111111111111111