111111111111111111111111111111
122222222222222222222222222221
122222502222222222222222222221
122220000222222222222222222221
122220000222222222222222222221
122220000222222222222222222221
122220222222222222232222222221
122220222222222222232322222221
12222022222222e222232322222221
122220222222222222432322222221
122220222222222222432322222221
122220222222222222232322222221
122220222222202222232322222221
122220222222202222222222222221
122220222222202222222222222221
122000222222202222222222222221
155000022222202222222222222221
150000000000002222222222222221
150002222222222222222222222221
111111111111111111111111111111