111111111111111111111111111111
1e2222322500000222232322022221
122322222232222222432223322321
132220000222232222222223222321
122220500242222222222222222221
111111111111111111111123222221
125000222222323332222222200321
102230002222422222222322505221
104234222200200000022322000221
104233320000000500022322220221
104324200322222220022322000221
152222202222222220522322244221
102222252222202244222322244221
102232221111111111111111111111
122222322233223225023332223221
122002222223002220032232222221
102202022222000000022232000021
100002222222052220023222500021
152222223222222220022322222221
111111111111111111111111111111